.......................................................................................................................
.......................................................................................................................
.......................................................................................................................
.......................................................................................................................
.......................................................................................................................
.......................................................................................................................
.......................................................................................................................
.........................................................#####..........................................#####..........
.......................................................................................................................
.......................................................................................................................
......................................#####..........................................#####.............................
.......................................................................................................................
.................#####..........................................#####..................................................
.......................................................................................................................
.......................................................................................................................
.......................................................................................................................
..P..................................................................................................................X.
.......................................................................................................................
#######################################################################################################################