.......................................................................................................................
.......................................................................................................................
.......................................................................................................................
.......................................................................................................................
.......................................................................................................................
.......................................................................................................................
.......................................................................................................................
.........................................................#####..........................................#####..........
.......................................................................................................................
.......................................................................................................................
......................................#####..........................................#####.............................
.......................................................................................................................
.................#####..........................................#####..................................................
............................#####......................................................................................
............................#####......................................................................................
............................#####......................................................................................
..P.........................#####....................................................................................X.
.......................................................................................................................
#######################################################################################################################