#......................................................................................................................
#......................................................................................................................
#......................................................................................................................
#......................................................................................................................
#......................................................................................................................
#......................................................................................................................
#......................................................................................................................
#........................................................#####..........................................#####..........
#......................................................................................................................
#...........................#####......................................................................................
#...........................#####.....#####..........................................#####.............................
#...........................#####......................................................................................
#................#####......#####...............................#####..................................................
#......................................................................................................................
#......................................................................................................................
#................S....................D................................................................................
#.P..................................................................................................................X.
#......................................................................................................................
#######################################################################################################################