................................................................................................................................................
................................................................................................................................................
................................................................................................................................................
................................................................................................................................................
................................................................................................................................................
................................................................................................................................................
................................................................................................................................................
.........................................................#####...................................................................#####..........
................................................................................................................................................
................................................................................................................................................
......................................#####...................................................................#####.............................
................................................................................................................................................
.................#####...................................................................#####..................................................
................................................................................................................................................
................................................................................................................................................
................................................................................................................................................
..P...........................................................................................................................................X.
................................................................................................................................................
################################################################################################################################################