....................
..............###...
....................
....................
.........###........
....................
....................
....###.............
....................
..P.............X...
####################
