........................................................................
........................................................................
........................................................................
........................................................................
........................................................................
........................................................................
........................................................................
.........................................................#####..........
........................................................................
........................................................................
......................................#####.............................
.................#####..................................................
.................#####..................................................
........................................................................
........................................................................
........................................................................
........................................................................
..P..................................................................X..
########################################################################
