.......................................................................................................
.......................................................................................................
.......................................................................................................
.......................................................................................................
.......................................................................................................
.......................................................................................................
.......................................................................................................
........................................................................................#####..........
.......................................................................................................
.......................................................................................................
.................#####................#####.....#####................#####.............................
.................#####..........................#####..................................................
.................#####..........................#####..................................................
.......................................................................................................
....M..................................................................................................
.......................................................................................................
....P................................................................................................X.
.......................................................................................................
#######################################################################################################