................................................................................................................................................
................................................................................................................................................
................................................................................................................................................
................................................................................................................................................
................................................................................................................................................
................................................................................................................................................
................................................................................................................................................
.........................................................#####...................................................................#####..........
................................................................................................................................................
................................................................................................................................................
.................#####................#####..............................................#####................#####.............................
.................#####...................................................................#####..................................................
.................#####...................................................................#####..................................................
................................................................................................................................................
................................................................................................................................................
................................................................................................................................................
................................................................................................................................................
..P...........................................................................................................................................X.
################################################################################################################################################